......#..#....#...#...#......#
..##..#...##.###.#..#.....#.#..
#..#.#....#......#..#.........#
.#..##...#........#....#..#..#.
#.#.#....###...#........#.....#
.#...#.#.##.#.##...#.#.........
####......#.......###.##.#.....
..#...........#...#.#.#........
.#.......#....###.####..#......
...##........#....##.......##..
.###......##.#......##....#.#.#
........#.#......##...#......#.
#....##.#..#...#.......#.......
.#..##........##.........#....#
.#..#..#...#....#.#......#.#...
..#.#......##.#.......#....##..
......##......#.#..##.#..#...#.
.....##.......#.#....#.#.......
........#.....#.....#..###.#...
#........#..#.....#...#.#.#..#.
.#..#.....#...#........#.....#.
.#.#.....#.....#...#...........
.....#.#..#..#...#..#..#..##..#
##.#...#....#..#.##..#.....#.#.
#.......####......#..#.#....#..
......#.#...####.........#.#..#
.#.........#..#.#...#..........
...#####.#....#.#..#......#.#.#
##....#.###....##...##..#.....#
...........####.##.#....##.##..
#.#.#..........#.#..##.#.######
##...#..#...........###..#....#
.#.#.#...##..........##.#...#..
...#.#........#..##...#....#...
......#..#...#..##....#.......#
.#..#.......#..#......##....##.
.......#.......#........#..##..
...#...#...#.##......#.##.#....
.........#.........#.#.#.##....
..#...................#....#..#
.........#..#.....#.#...#....#.
#.#.#...#........#..###.#......
#.#.#.####......##...#...#....#
#...........##..#.#.#....#..#..
........#..#.#...........##.#.#
.#.........#...........#..#....
#............##.#..#....##...##
.#....##..#.#....#.......#..#..
..#.#...#.#......####.......#..
...#.#.......###......#.....#..
#......#.......#.#...#.#..##...
...#.....#...##.#.....#.#......
#.#.#............#..#......#..#
....#...#...##.##.##...##.#....
..##........#..#........#...##.
.......#..#...#.........#.....#
...........#.#......#...#......
...##..##..##..###..#..#..#..#.
#..##.......##..#....#....#.#..
#.#.##.#..##.....#....#.#......
....#..##......#.#..#....#....#
.#.#.........##...#......##.##.
##...........#..#.....#.###....
.#.###........#...#....##..#...
......##.....#.................
.#.##..#.#.......#......#.#.#..
.#...#....#.##..........##.##..
#...##......####.#....#....#...
.#...#.##.#.#.....#...#........
.#................#.##.#.###...
...#.#..#.#.....##.....##....#.
..##.#..#..##.....#....#...#.##
........###.##..#..###.....#..#
..##.....#.......#.#...##......
#.#..###...##.###.##.#..#...#..
#..#..#.#...#....#...##.....#.#
#..................#........#..
#.....#.......#.##....##....#..
...#.............#.....#...#...
...#...#.##..##.....#........#.
.......#........##....###..##..
.#....#....#.#..#......#....#.#
..........#..#.#.....##...#.##.
.#...##.#...........#.#.......#
..#.##.....#.###.#.............
..#....###..........#.#.#......
#.....#.####..#.#......#..#.#.#
...#........#..#...............
.###.#.##.....#.#...........#..
..#....#..#....#..##....#......
......#..#.....#.#.##.......#.#
###..#...#.#..#....#..##.###..#
.#....##.###........##...##.#.#
........##..##.#....##..#....#.
...#..#....#.#....#...#...##...
#.....#......#.##........#....#
....#....###.##...#.#.##....#..
......#.##..#.#..........#...#.
...........#...#....##...#....#
......#.#.........#....#.#.#...
.###..........#.###.##....#...#
...##.......#......#....#....#.
#..#...#.#..####...#......#..#.
....##..#.#.........#..........
.##.###.##....##.####....#...#.
..##.......#........#...#..#...
....#####..........###....#....
.#.#..#.#.#....#..#............
........#.....#....#.......##..
...........##....##..##.....##.
..###........#.#.#..#....##...#
.....#...........##......#..#..
...##........#.##.#......##..#.
##..#....#............##..#..#.
.#.....#...##.##..............#
#..##........#...#...#......##.
......##.....#.......####.##..#
...#.#....#...#..#.............
..#...#..##.###..#..#.......##.
##....###.......#...#..#.......
#..#.....###.....#.#.........#.
#.#....#.............#...#.....
..#.#.##..........#.....##.#...
.....##......#..#..#.....#..#..
##.#..#..#.##......###....#..#.
...#............##...#..##.....
.#..#....#.........#......#.##.
.##.##...#..............#..#.##
...#....#...###...#...#....#..#
..#...#..####..#....#.#...##..#
..............##.##.......##...
..##.#..##...........#.#.#...#.
..................##.####.###..
.#...........#.......#......#..
.#.#.#...#....#.........##...##
....#..........#.#....#.#.....#
..........#.#..........#.#.....
...........#.....#.#......#....
........#..#.#.#.#.............
...###...##...##..####.##......
.#..#......###.....#...#.....#.
.........##............#.#.....
#.#..#.#.#....###.#.#..#..#..##
..........#...#.##.#..#..#....#
#..#.......##....#..##........#
##.#...#....##.............#...
....#........#......##..#..#.##
.................#.#.#.#.#.....
...........#.#.....#.......#...
#.......#.......#............#.
....#...........#.#.##.....#..#
#...#.....#....#..##...#.......
..#.....#.....#.##.##....#.....
.#.#..#...#..#..##.....##..#...
.#.#....#.........####.........
#...#..####.....#...#..##......
..#...##.#.....#...#.....##....
.#...#.....#.#.#......#.......#
..#.....##.#..#.#...##.........
##.#...#..#....#....#.##.##...#
.#..#....#..##.#.......#..#....
...##.#......#...###.......#...
...#..#.........##.####........
#.#..#..##...........#..#......
.#...#.#......#.#..........#...
...###...#.......#.....#.#...##
..#....#.#.##..........##...#..
.....###.........#.....#..##..#
.......##.....#.#.....#.#..##..
.#.#.###..##.......##...#......
......#.....#................##
.#......##..##.#.#...#...#...##
.#...#......#.......#.#........
.#..........###...#..#...#.....
.........##.....#.#..#..#.#...#
#...#...#.........#..#..#....#.
###.......#.#.....#....##......
.#..#......#..#...........#..#.
..##....##..##...#......#......
.#........#....#...#....#.....#
.#.......#...#...#..##.#.#..#..
#...#........#.##.....#.....#..
#..##.....#..........#...#...##
............#...............#..
.#.##...#.....#.#..#..#..#.....
.#.#.#...#........#....#...##..
##......#.....#.###.#...#.#..#.
.........##..#..#.#...#...#...#
#...#.#....#..#..#.....#.......
.......#.###...#.............#.
..#.....#.#.#..###.#....#.....#
....#...#.#....#.#..........#..
..#......#.###.#.#..#.....#...#
#............#..##...##......#.
#...........#..#....#.###..###.
.#.##.#.#.......#.............#
..............#................
..#.#.....#.....#...#......#...
.#.#.#..#..#.#...........##....
.....##.#......#..#.##....#....
.......##..#.#.#..#............
..#.....#.....#.###..#.....#.#.
......##.....#..##.#...#.....#.
...#...#....#..#..#........#...
..#.##..#....#.........#.#..#..
#....#.....###.....#......#....
##.....#..#..##.........#.##.##
.#.#....#.#..........#.........
.##.#...#..#.......#.##...#....
...#...#.....#....#...#.#..#...
.....#....#.....#.....#.#......
...........#.#.......#.......#.
.........##.###.##........#....
#..##.....#...#.#..............
.#...#....##........#.#..#....#
..#...#........#...#..#.##.#..#
........#...#.....##.#.#....#.#
#..#.......###.#....#.#.#......
.......#...##....#...#..##..#..
.....##........#.#.#..#....##..
.#....#..#.#...........#......#
...##....#.##.....##.......#...
.##..#..#....#.#....#..#....##.
..#....#.....###.......#..##..#
....#.......#....##..#....#..##
....#......##..#....#.#...#.#..
.##.#......##..................
##.#....#........#..#..#...##.#
.......#..#.#...##.....#.#.....
..##.#...........#.#.#..#.#.#..
.....#....#......#..#.......#..
#.#...#.####..##.......#..##...
...#....#.....#.##.#..#.##..#..
.#.......#......##........##.#.
.......#.#...#..#...#..##.#....
.#....#........#.#.....##..#..#
#..#.....#..#.............#...#
#...#....#..#...###..#...#.#...
.#..#.....#..........#..##.####
#.#.#.#.##.#.#.....##.#........
...#....##....#...#..##.......#
..##.##.#.#........#..........#
..###........###..#..........#.
...#......#..##.#........#..#..
#.#.#..#........#..#..........#
...#........#..##.#...#.###....
##......#.####.#....#......#...
.#..#......#................#..
#.#........#.#.....##.....##...
#...............#..#.......#.#.
.##..#...........##..#..#.#....
#......#.#.......#.#.#.##..#.##
.....##.#..###.............##..
....##.........#..#...#........
.....#.....#.#.#..#.#..........
#.........#....##.#.##.....#..#
.#.........#......#.#.##.#.#...
##.........#.....#..#.#..#.##.#
....#......##...#.....#..#..###
..#..............#...#..####...
#....#...##.#.......#...#..#...
#.......###.#.#.......#.......#
...##....#.#...........#...###.
...........#..#.#.....#..##..#.
..#.........#..###..#.....#...#
..#.#.....#.#.#...#.#.#......#.
........#.....#.#......##....##
##.#.#...#.#........#.....#...#
........#....#...............#.
##.###......####...#####..#....
...##...#..#....#........#...#.
...###.#..................##.#.
##.#.......###.......#...#.#...
....#..#.#...#...#....#.#.#..##
....#...........#..#...........
#..#.#..#...#...#..#...........
...#...#.#....#..#....#........
#....#.......#.##........#..#..
.....#...#..#................#.
#......#.......#..........##..#
.#....#.#......#.#...#....##..#
...#.##...#......#.#...##...##.
..#...#..##...#...#....#.......
.....#....#.#.#..........#.#...
...#...#..#....#..#.#..........
......#.#..........##.......#..
.#...##.#.#...#..##..#...#.....
..#..#.........#........#.#.#..
#.#..##..#.....##......#.....#.
#..#.....#.#....#...#.#....#.#.
......#........##.#..#...#.....
...#.##.#.#......#.#..##...#..#
....#..###..#..#.....###....##.
.....#...#.#.....#..........#.#
.#...##..##.....#..#...#.#.#...
.##.#......##...##..#...#.....#
.#.##....#...#.##.#.#...#.#...#
....#.#...#....###.#.....#.....
#.....####................#..#.
....#.....#...#.#.......##.#...
.#...##.#...#..#...........#.#.
..#####..#.#...#...##........#.
...#...##........#...#.#....###
........#.#.#..#.....#.......#.
...#...#..##............##.....
#.#..###....###.#...#.#...##.##
..#.##...#......#..#.........##
.##..#..#.....#..#.........#.#.
.#..#.#....#.##...#..#.##....##
..#...#.#...##.#.#...#...#....#
#..........#.......##..##....#.
#...###.#......#....#.........#
#.....#...##.......##....##....
.##.#..#.##......#.##....#..#..
............#.#....##.#..#....#
.#.........##.##...#....#.....#
##....##..#..#....##...#.....##
...#.....#...........#.....##..
......#...#.........#.......#..
............#...##.#.....#.#.#.
.#........##..........#.....#.#
.###.........#.....#.##...#....
.##..#...##...#..#..#.##.......